211111111111111111111112
100000000000000000000001
100000000000000000000001
100000000000000000000001
100000000000000000000001
100011000001100000010001
100001000001100001110001
100001110001100001000001
100000010001100111000001
100000011001100100000001
100000000001100000000001
100000000001100000000001
100011111111111111110001
100000000001100000000001
100000000001100000000001
100000001001100110000001
100000111001100010000001
100000100001100011100001
100011100001100000100001
100010000001100000110001
100000000000000000000001
100000000000000000000001
100000000000000000000001
100000000000000000000001
211111111111111111111112