211111111111111111111112
100000000000000000000001
100000000000000000000001
100000000000000000000001
100011110000000000000001
100010010000000000000001
100010010000000000000001
100011110000000000000001
100000000000000000000001
100000000111111000000001
100000000100001000000001
100000000100001000000001
100000000100001000000001
100000000111111000000001
100000000000000000000001
100000000000000011110001
100000000000000010010001
100000000000000010010001
100000000000000011110001
100000000000000000000001
100000000000000000000001
100000000000000000000001
211111111111111111111112