211111111111111111111112
100000000000000000000001
100000000000000000000001
100000000000000000000001
100000000000000000000001
100000000000000000000001
100000000001000000000001
100000000011000000000001
100000000101000000000001
100000000001000000000001
100000000001000000000001
100000000001000000000001
100000000001000000000001
100000000111110000000001
100000000000000000000001
100000000000000000000001
100000000000000000000001
100000000000000000000001
100000000000000000000001
100000000000000000000001
100000000000000000000001
100000000000000000000001
211111111111111111111112