211111111111111111111112
100000000000000000000001
100000000000000000000001
100000000000000000000001
100000000011100000000001
100000001100011000000001
100000010000000100000001
100000100000110010000001
100000100000110010000001
100001000000000001000001
100001000101010001000001
100001001010101001000001
100000100000000010000001
100000100000000010000001
100000010000000100000001
100000001100011000000001
100000000011100000000001
100000000100010000000001
100000001000001000000001
100000010000000100000001
100000111111111110000001
100000000000000000000001
100000000000000000000001
100000000000000000000001
211111111111111111111112