211111111111111111111112
100000000000000000000001
100000000000000000000001
100000000000000000000001
100000000000000000000001
100000000000000000000001
100000000000000000000001
100000000000000000000001
100001111100001111100001
100000101000000101000001
100000101000000101000001
100000000000000000000001
100000000001000000000001
100000000010100000000001
100000000100010000000001
100000001111111000000001
100000000000010000000001
100000000000010000000001
100000000000000000000001
100000000000000000000001
100000000000000000000001
100000000000000000000001
100000000000000000000001
100000000000000000000001
211111111111111111111112