211111111111111111111112
100000000000000000000001
100000000000000000000001
100000000000000000000001
100000100000100000100001
100001010001010001010001
100010001010001010001001
100100000100000100000101
100000000000000000000001
100000000000000000000001
100000000000000000000001
100000100000100000100001
100001010001010001010001
100010001010001010001001
100100000100000100000101
100000000000000000000001
100000000000000000000001
100000100000100000100001
100001010001010001010001
100010001010001010001001
100100000100000100000101
100000000000000000000001
100000000000000000000001
100000000000000000000001
211111111111111111111112