211111111111111111111112
100000000000000000000001
100000000000000000000001
100000000000000000000001
100000000000001000000001
100000000000010100000001
100011111110000011110001
100000000000000000000001
100000000000000000000001
100011111110011111110001
100011111110011111110001
100000000010000000000001
100000000010000000000001
100000000010000000000001
100000000010000000000001
100000000010000000000001
100101010011100100101001
100101010011100100101001
100000000000000100000001
100000000000000100000001
100000001111111100000001
100000000000000000000001
100000000000000000000001
100000000000000000000001
211111111111111111111112